PPPPPPPPPPPPPPPPPPPP
PPPPPPPPPPPPPTPPPPPP
PPPPPPPPPPPPPPPPPPPP
PPPPPTPPPPPPPPPPPPPP
PPWWPPPPPPPPPPPPWWWW
PPWWPPPPPPPPPPPPWWWW
PPPPPPPPPPPPPPPPPPPP
PPPPPPPPPPPPPPPPPPPP
PPPPPPPPPPTPPPPPPPPP
PPPPPPPPPPPPPPPPPPPP
PPMMMPPPPPPPPPPPPPPP
PPPPMPPPPPPPPPPPPPPP
PPPPPPPPPPPPPPPTPPPP
PPPPPPPPPPPPPPPPPPPP
PPPPPPPPPPPMMMMPPPPP
PPPPPPPPPPPPMMMPPPPP
PPPPPPPPPPPPPPPPPPPP
PPPTPPPPPPPPPPPPPPPP
PPPPPPPPPPTPPPPPPPPP
PPPPPPPPPPPPPPTPPPPP
